# Add your own words in following this format:
# letter case is ignored in testing
#
# æ
# þ
# ð
#
# The Dream of the Rood
# Part 2: The Cross' Monologue
geara iu: very long ago
gyta: yet; still
gemunan: to remember
aheawan: to cut down
holt n.: wood; forest
ende m.: end; edge
astyrian: to remove
stefn m.: root; stem
geniman: to take; seize
strang: strong
feond m.: enemy 
gewyrcan: to make; form
wæfersyn f.: spectacle
hatan: to command; order
werg m.: criminal
hebban: to raise up
beran: to carry; bear
beorn m.: warrior; man
eaxl f.: shoulder
beorg m.: hill; mountain
asettan: to set; set up
geæstnian: to fasten
genog: enough
geseon: to see
frea m.: lord; master; the Lord
mancynn n.: mankind
efstan: to hasten
elne micle: with great courage
willan: to wish; desire
gestigan: to climb up; ascend
Dryhten m.: lord; the Lord
ofer: over; against
bugan: to bow
berstan: to break
bifian: to tremble
eorðe f.: earth
sceat m.: surface; region
eall: all
gefyllan: to fell; knock down
fæste: firm(ly)
standan: to stand
ongyrwan: to strip; undress
geong: young
hæleð m.: hero; warrior; man
strang: strong
stiðmod: resolute; brave
gestigan: to climb up; ascend
gealga wk m: gallows
heah: high
modig: brave
manig: many
gesyhð: sight; vision
willan: to wish; desire
lysan: redeem; set free
bifian: to tremble
ymbclyppan: to embrace
bugan : to bow
feallan: to fall
folde f.: earth; ground
sculan: to have to
Rod: Rood; Cross
aræran: to raise up
ahebban: to raise; lift
rice: powerful
cyning m.: king
hlaford m.: lord
hyldan: to bow; bend
þurhdrifan: to drive through; pierce 
deorc: dark 
nægl m.: nail
dolg n.: wound
gesiene: visible
inwidhlemm m. : malicious wound
ænig: any
sceððan: to injure
bysmerian: to mock; revile
unc: the two of us
butu: both
ætædere: together
eall: entirely
besteman: to make wet; drench
begeotan: to drench; cover; cover with moisture
guma wk m.: man
side f.: side
siððan: æfter
gast m.: spirit
onsendan: to send
feala: many
beorg m.: hill
bebidan: to experience
wrað: cruel
wyrd: fate; event
geseon: to see
werud: troop; host
þearle: severely; cruelly
þenian: to stretch out
þystro: darkness
bewreon: to cover
wolcen m./n.: cloud
Wealdend m.: Ruler
hræw n.: corpse
sciru: bright; gleaming
scima m.: radiance
sceadu f.: shadow
forð: forth
gan: to go
wann: dark
wepan: to weep
gesceaft f.: creation
cwiðan: to lament
fyll m.: fall; death
fus: eager
feorran: from afar
cuman: to come
Æþeling: prince
behealdan: to behold
sare: sorely
sorg f.: sorrow
gedrefan: to afflict
hnigan: to bow down
secg m.: man; warrior
eaðmod: humble
ellen: courage; strength
geniman: to seize; take
ahebban: to lift up
hefig: heavy
wite n.: torment
hilderinc m.: warrior
steam: moisture
bedrifan: to cover; sprinkle
stræl m/f: arrow
forwundian: to wound severely
alecgan: to lie down
limwerig: weary of limb
gestandan: to stand
lic n.: body
restan: to rest
meðe: exhausted
gewinn n.: battle; strife; conflict
onginnan: to begin; proceed
moldern n.: sepulchre; grave
wyrcan: to make
bana wk m: slayer
ceorfan: to cut
beorht: bright; shining
stan m.: stone
sigor m.: victory
sorhleoð n.: song of sorrow; dirge
galan: to sing
earm: wretched
æfentid: evening time
siðian: to journey
mære: famous; glorious; renowned
þeoden m.: prince; lord
mæte: small
weorod m.: troop
greotan: to weep
staðol m.: position
stefn: voice
gewitan: to go
hilderinc m.: warrior
hræw m.n.: body; corpse
colian: to cool
fæger: beautiful; fair
feorgbold n.: dwelling of life; body
fyllan : to fell
onginnan: to begin
egeslic: terrible
wyrd f.: fate; experience
bedelfan: to bury
seað m.: pit
Dryhten m.: Lord
gefrinan: to find out about; hear
gyrwan: to deck; adorn
magan: to be able
gehyran: o hear; understand
hæleð m.: man; hero; warrior
leofa: beloved; dear
weorc n.: work
bealuware m.pl: evil men
gebidan: to experience; endure
sar: grevious; sore
sorg f. : sorrow; grief
sæl m.f.: time
weorðian: to honour
wide and side: far and wide
molde f.: earth
mære: renowned
gesceaft f.: creation
gebiddan: to pray
beacen n.: sign; symbol; beacon
bearn n.: child
þrowian: to suffer
for þan: therefore; and so
þrymfæst: glorious
hlifian: to tower
hælan: to save; to heal
magan: to be able
æghwylc: each
an: one
egesa wk m.: awe
iu: long ago
weorðan: to become; be
wite n.: torment
heardost: hardest; most grievous 
leode m. f. pl: people
laðost: most hateful
ær þan: before
lif n.: life
weg m.: way
riht: right
geryman: to open
reordberend m.: speechbearer
geweorðian: to honour
wuldor n.: glory
Ealdor m.: prince; chief
holtwudu m.: wood/tree of the forest
heofonrice n.: heavenly kingdom
Weard m.: Guardian
swylce swa: just as
modor f.: mother
eac: also
Marian sylfe: Mary herself
for: before
wif n.: woman
cynn n.: race; kind
hatan: to command; order
gesyhð f.: sight; vision
secgan: to say; tell
onwreon: to reveal; disclose
beam m.: tree
þrowian: to suffer
synn f.: sin
ealdewyrht f. n. : deed of old; former action
byrigan: to taste
hwæðere: however; yet
arisan: to arise
micel: great
miht f.: power; might
astigan: to ascend; proceed
hider: hither
fundian: to set out
middangeard m. : world; earth
secan: to seek
domdæg m.: day of judgement; Doomsday
engel m.: angel
deman: to judge
dom m.: judgement; doom
geweald n.: power; control
an: one 
gehwylc: each
ærur: earlier; formerly
læne: transitory
geearnian: to earn; deserve
unforht: fearless
wesan: to be
Wealdend m.: ruler
frinan: to ask
mænigo f.: multitude
Dryhten m.: Lord
nama wk m.: name
onbyrigan: to taste
forhtian: to be afraid
fea adv.: little
onginnan: to begin
cweðan: to say; speak
anforht: afraid
selest: best
rice n.: kingdom
gesecan: to seek
eorðwege m.: earth
æghwylc: each
sawol f.: soul
wunian: to dwell